11111111111111111111111111111
11111111111111111111111111111
11111111111111111111111111111
11111111111111111111111111111
11111111111111111111111111E11
11111111111111C1111111111CC11
111111111111111111111111CCCC1
11111111111111111111111111P11
11111111111111111111111111111