111111111111111111111111111111
1P00000000111C0000000000000001
101111111010011111111111110101
100010000010000000001000000001
111011111010111111101011111101
100000000000100000E01000000001
101111111111101111111011111101
100000000001000000000010000001
101111101101111111111110111101
10000C100000000000000000000C01
111111101111111111111111101111
100000001000000001000000101001
101111111011111100011111101001
100000000010000001000000100001
111110111110111101011110111111
100000100000000001000100000001
101111111111111101111111111101
10000000000C000001000000000E01
111111111111111111111111111111,

iki exit var
bos map patliyo