111111111111111111111
100000000000000000001
100000000000000000001
10000000000000C000001
100000C00000100110001
1P0000000001101001001
100000000010100010001
100000000111100100001
100000000000101111001
100000000000000C00001
10000000000C000000001
10000000000000E000001
111111111111111111111