111111
111C11
111E11
111P11
111111