111111
101C11
101E11
101P11
111111